R 1080 720
NO ./textures/eagle.xpm
SO ./textures/greystone.xpm
EA ./textures/red.xpm
WE ./textures/purplestone.xpm
S ./textures/tonneau.xpm
F 33,47,60
C 46,130,193

        1111111111111111111111111
        1000000000110000000000001
        1011000001110000002000001
        1001000000000000000000001
111111111011000001110000000000001
100000000011000001110111111111111
11110111111111011100000000001
11110111111111011101010010201
11000000110101011100000010001
10002000000000001100000010001
10000000000000000001010010 01
11000001110101011111011110N01
11110111 1110101 101111010001
11111111 1111111 111111111111
